あ	阿	名詞	こそあど
ああ	阿あ	名詞	
あいつ	阿いつ	名詞	
あいろ	隘路	名詞	
あさいしき	麻井シキ	人名	
あそこ	阿所	名詞	
あそびめ	遊び女	名詞	「遊び眼」ではない
あちら	阿ちら	名詞	
あっち	阿っち	名詞	
あなた	阿方	名詞	
あの	阿の	名詞	
あまみやかりん	雨宮処凛	人名	
あらかじめ	豫め	副詞	
あれ	阿れ	名詞	こそあど
あれだけ	阿れ丈	名詞	
あんな	阿んな	名詞	
い	爲	名詞	
いい	好い	名詞	
いのうえさちろう	井上幸亨郎	人名	
いふ	云ふ	動詞ハ行四段	
いふ	謂ふ	動詞ハ行四段	
いよいよ	愈々	副詞	
いりあせんき2	イリア戰記Ⅱ	固有名詞	
いんすう	引数	名詞	
いんようかく	引用格	名詞	
ゔぁすばんどぅ	世親	人名	せしん
ゔぁすばんどぅ	वसुबन्भु	人名	世親
うしなはれ	失はれ	動詞ハ行四段	
うたかた	囁き(うたかた)♪	固有名詞	
うなづき	頷き	名詞	
うなづく	頷く	動詞カ行五段	
え	繪	名詞	
えいえんきょくげん	永遠極限	名詞	<=> 此の経験
えうえゆい	暎上柚葦	人名	
おう	應	名詞	
おなじ	〳〵	名詞	踊り字
おぼえ	覺え	名詞	
おぼえる	覺える	動詞ラ行五段	
おぼゆ	覺ゆ	動詞一段	
おもはれ	思はれ	動詞ハ行四段	
が	畫	名詞	
かいが	繪畫	名詞	
かいへいせい	開平性	名詞	<=> 累乗性
かがく	科學	名詞	
かかはる	關はる	動詞ラ行五段	
かく	斯く	名詞	
かく	覺	名詞	
かごしま	鹿子島	姓	鹿子島龍一
かさねねてと	重音テト	人名	UTAU、じゅうおんてと
かし	〽	記号	
かず	數	名詞	
かぞへる	數へる	動詞ハ行四段	
かな	假名	名詞	
かなり	可成り	副詞	
かなん	彼男	名詞	「彼」を中性、「彼女」を女性として
かの	彼の	名詞	
かほ	夏帆	人名	
かみ	神	名詞	
かむよ	神代	名詞	
かり	假	名詞	
かん	關	名詞	
かん	觀	名詞	
かん	歡	名詞	
かんけい	關係	名詞	
かんげい	歡迎	名詞	
かんげん	還弦	名詞	還元＋管弦
かんげんしゅぎ	還弦主義	固有名詞	還弦主義8760時間
かんれん	關聯	名詞	
き	氣	名詞	
きづく	築く	動詞カ行五段	
きゅう	舊	名詞	
きゅうかな	舊假名	名詞	
きゅうじ	舊字	名詞	
くうき	空氣	名詞	
くらい	位い	副詞	
くれ	呉れ	動詞ラ行五段	
くれかわよしあき	呉川良融	人名	
くれた	呉れた	動詞ラ行五段	
くれづきまあり	紅月真有	人名	
くれる	呉れる	動詞ラ行五段	
くろ	黑	名詞	
くろい	黑い	形容詞	
くろく	黑く	形容詞	
け	氣	名詞	
けんこく	建國	名詞	
けんこくしゃ	建國者	名詞	
げんにど	減二度	名詞	和音
こ	此	名詞	こそあど
こいつ	此いつ	名詞	
こう	此う	名詞	
こう	廣	名詞	
こうい	行爲	名詞	
こえ	聲	名詞	
こくようか	黒陽花	名詞	黑陽花
こくようか	黑陽花	名詞	
ここ	此所	名詞	
ここ	此處	名詞	
こそあど	此其阿洞	名詞	此れ其れ阿れ洞れ
こたへる	應へる	動詞ハ行四段	
こちら	此ちら	名詞	
こっち	此っち	名詞	
こなた	此方	名詞	
この	此の	名詞	
このけいけん	此の経験	名詞	<=> 永遠極限
これ	此れ	名詞	こそあど
これすみももか	惟住桃香	人名	
これだけ	此れ丈	名詞	
こんごう	交合	名詞	
こんな	此んな	名詞	
さちろう	幸亨郎	名	井上幸亨郎
さふ	然ふ	名詞	然う
さふか	然ふか	名詞	然うか
さま	樣	名詞	
さます	覺ます	動詞サ行五段	
さまよい	彷徨い	名詞	
さまよい	呻吟い	名詞	
さまよう	彷徨う	動詞ワ行五段	
さまよう	呻吟う	動詞ワ行五段	
さめる	覺める	動詞ラ行五段	
さゆみ	幸佑美	名	井上幸佑美
さん	參	名詞	
さんか	參加	名詞	
し	視	名詞	
じ	辭	名詞	辞
しお	鹽	名詞	
しかく	視覺	名詞	
しかして	而して	接続詞	
しきひらただ	志姫平惟	人名	
しける	濕氣る	動詞ラ行五段	
じし	辭詞	名詞	
しぜんかがく	自然科學	名詞	
しぜんぞうがく	自然像学	名詞	<=> 自然科学, 自然哲学
しぜんたい	自然態	名詞	
しっけ	濕氣	名詞	
しっける	濕氣る	動詞ラ行五段	
しぶさわたつひこ	澁澤龍彥	人名	
しまう	了う	動詞ワ行五段	仕舞う
しめる	濕る	動詞ラ行五段	
じゅうおんてと	重音テト	名詞	UTAU、かさねねてと
じゅうしょ	東京都江戸川区平井1-18-10ハートピア平井103号室	固有名詞	
しょ	肇	名詞	
しょ	處	名詞	
じょう	狀	名詞	
じょうたい	狀態	名詞	
しん	神	名詞	
しんたい	神代	名詞	
じんぶんかがく	人文科學	名詞	
しんわ	神話	名詞	
すう	數	名詞	
すうし	數詞	名詞	
すうめい	數名	名詞	
すく	好く	名詞	
すだち	酢橘	名詞	
すべて	總て	名詞	
せかいかん	世界觀	名詞	
せかいしせん	世界視線	名詞	
ぜっきょう	Z境	名詞	
ぜったいかく	絶対格	名詞	
せっとうじ	接頭辭	名詞	
せつびじ	接尾辭	名詞	
せん	戰	名詞	
せんき	戰記	名詞	
そ	其	名詞	こそあど
そいつ	其いつ	名詞	
そう	其う	名詞	
そう	然う	名詞	
そう	總	名詞	
そうか	然うか	名詞	
ぞく	續	名詞	
ぞく	屬	名詞	
ぞくする	屬する	動詞サ行五段	
そこ	其所	名詞	
そこ	其處	名詞	
そして	然して	接続詞	
そちら	其ちら	名詞	
そっち	其っち	名詞	
そなた	其方	名詞	
その	其の	名詞	
そもそも	抑々	副詞	
それ	其れ	名詞	こそあど
それだけ	其れ丈	名詞	
そんな	其んな	名詞	
だい	臺	名詞	
だいさんだんかい	第三段階	名詞	
たいた	対他	名詞	
だけ	丈	接尾一般	
たたかう	戰ふ	動詞ハ行四段	
たたかひ	戰ひ	名詞	
たちえ	立ち繪	名詞	
たちばなはるな	橘榛名	人名	
たつみのぶ	辰巳暢	人名	
たでゐやくはく	蓼井約伯	人名	辰巳暢
ため	爲	名詞	
ために	爲に	副詞	
ための	爲の	副詞	
ちゅうくらい	中位い	名詞	
ちゅうぐらい	中位い	名詞	
ちょうふく	調伏	名詞	
つづく	續く	動詞カ行五段	
てんき	天氣	名詞	
ど	洞	名詞	こそあど
という	と云う	名詞	
どいつ	洞いつ	名詞	
どう	洞う	名詞	
どうか	洞うか	名詞	
とうかく	等格	名詞	
とうち	等置	名詞	
どうち	同致	名詞	
とうちする	等置する	動詞サ変	
どうちする	同致する	動詞サ変	
どこ	洞所	名詞	
どこ	何處	名詞	
ところ	處	名詞	
どちら	洞ちら	名詞	
どっか	洞っか	名詞	
とつげんへんい	突弦変異	固有名詞	平沢進
どっち	洞っち	名詞	
とても	迚も	副詞	
どなた	洞方	名詞	
どの	洞の	名詞	
どれ	洞れ	名詞	こそあど
どれだけ	洞れ丈	名詞	
とゎのすーどり	トヮノスー鳥	名詞	
どんな	洞んな	名詞	
なーがーるじゅな	龍樹	人名	りゅうじゅ
なーがーるじゅな	नागार्जुन	人名	龍樹
ないほうか	内包化	名詞	
ないほうしせん	内包視線	名詞	
ながら	乍ら	名詞	
ならび	竝び	名詞	
ならぶ	竝ぶ	動詞バ行五段	
ならべる	竝べる	動詞バ行五段	
にしべすすむ	西部邁	人名	
ねざめ	寝覺め	名詞	
ねねねね	根音ネネ	名詞	UTAU
のうかく	能格	名詞	
のうせい	腦醒	名詞	knoseh
のために	の爲に	副詞	
のための	の爲の	副詞	
はじまり	肇まり	名詞	
はじめ	肇め	名詞	
はつ	發	名詞	
はっしゅたぐ	#c4se	固有名詞	Twitter
はっしゅたぐ	#twnovel	固有名詞	Twitter
はっしゅたぐ	#twpoem	固有名詞	Twitter
はっしゅたぐ	#iria2	固有名詞	Twitter
はっしゅたぐ	#tohoclock	固有名詞	Twitter
はっしゅたぐ	#book	固有名詞	Twitter
はっしゅたぐ	#js	固有名詞	Twitter
はっしゅたぐ	#Opera	固有名詞	Twitter
はっする	發する	動詞サ変	
はってん	發展	名詞	
はみゅるふぁりあ	黒陽花	名詞	黑陽花
はみゅるふぁりあ	黑陽花	名詞	
ひらさわすすむ	平沢進	人名	
ひろい	廣い	形容詞	
ふかもりこり	深森凝	人名	knoseh
ぶたい	舞臺	名詞	
ふにさや	芙爾沙夜	人名	
ふへんしせん	普遍視線	名詞	
ふるい	舊い	形容詞	
へい	竝	名詞	
へいかく	並格	名詞	
へいこう	竝行	名詞	
へいこうして	竝行して	動詞サ変	
へいこうする	竝行する	動詞サ変	
へいじょし	並助詞	名詞	
へんげんじざい	変弦自在	名詞	平沢進
ほうづき	酸漿	名詞	
まいる	參る	動詞ラ行五段	
また	復た	名詞	
み	實	名詞	
みる	觀る	動詞ラ変	
みる	視る	動詞ラ行五段	
めーる	lunatic.faily@yahoo.com	固有名詞	mail
めーる	utakata.c4se@gmail.com	固有名詞	mail
めーる	c4se@live.jp	固有名詞	mail
めーる	sachiro.inoue@drecom.co.jp	名詞	
もどき	擬き	名詞	
もどす	戾す	動詞サ変	
もどる	戾る	動詞ラ行五段	
ももんが	百々ん蛾	名詞	
ゆうびんばんごう	1320035	固有名詞	zip code
ゆるさなえ	許早苗	名詞	絶対許早苗
よ	豫	名詞	
よう	樣	名詞	
ようす	樣子	名詞	
ようどうせい	幼童性	名詞	
ような	樣な	副詞	
ように	樣に	副詞	
よこ	橫	名詞	
よこがな	横仮名	名詞	ひらがな、カタカナ
よこがな	橫假名	名詞	
よしもとたかあき	吉本隆明	人名	
よしろう	慶郎	名	井上慶郎
よてい	豫定	名詞	
よろこぶ	歡ぶ	動詞バ行五段	
らつ	喇	人名	
らんゆうえん	蘭裕園	固有名詞	
りょうがせかい	兩河世界	名詞	
りんしゅう	厘秀	名	
るいじょうせい	累乗性	名詞	<=> 開平性
れいかく	例格	名詞	
れん	聯	名詞	
れんぽう	聯邦	名詞	
わざわざ	態々	副詞	
